C 6
######
# A  #
# B@ #
#    #
#@@B #
######
