D 8
########
####  @#
#   B  #
#    @ #
#   @  #
# B    #
#    A #
########
