E 11
###########
# @  #  B@#
#   ###   #
#   #A#   #
# B       #
#      ####
#    ######
#        @#
#       B #
#    #@#  #
###########
