Z 15
###############
#@   ###      #
## B        B #
###           #
##            #
#   ###A###   #
#      @#     #
#     ###     #
#    # # #    #
#     @#@     #
#      #      #
####   #   #  #
#  B   @   #B #
#          #  #
###############
