W 11
###########
###########
#@    #  @#
#    #   @#
#    # B  #
#  #      #
#       A #
#  B  #   #
#     #   #
###########
###########
